76
78
3
3
|XXXXXXXXXXXXXXXXXXXXXXXXXXXXXXXXXXXXXXXXXXXXXXXXXXXXXXXXXXXXXXXXXXXXXXXXXXXXX|
|XXXXXXXXXXXXXXXXXXXXXXXXXXXXXXXXXXXXXXXXXXXXXXXXXXXXXXXXXXXXXXXXXXXXXXXXXXXXX|
|00000000000000000000000000000000000000000000000XXXXXXXXXXXXXXXXXXXXXXXXXXXXXX|
|00000000000000000000000000000000000000000000000XXXXXXXXXXXXXXXXXXXXXXXXXXXXXX|
|00000000000000000000000000000000000000000000000XXXXXXXXXXXXXXXXXXXXXXXXXXXXXX|
|XXXXX00000000XXXXXXXXXXXXXXXXXXXXXXXXXXXXXX0000XXXXXXXXXXXXXXXXXXXXXXXXXXXXXX|
|XXXXXX0000000XXXXXXXXXXXXXXXXXXXXXXXXXXXXXX0000XXXXXXXXXXXXXXXXXXXXXXXXXXXXXX|
|XXXXXX0000000XXXXXXXXXXXXXXXXXXXXXXXXXXXXXX0000XXXXXXXXXXXXXXXXXXXXXXXXXXXXXX|
|XXXXXX0000000XXXXXXXXXXXXXXXXXXXXXXXXXXXXXX0000XXXXXXXXXXXXXXXXXXXXXXXXXXXXXX|
|XXXXXXX000000XXXXXX000000000000000000000000000000000000000000000000000000000X|
|XXXXXXX000000XXXXXX00000000000000000000000000000000000000000000000000000000XX|
|XXXXXXX000000XXXXXX00000XXXXXXXXXXXXXXXXXXX00XXXXXXXXXXXXXXXXXXXXXX00000XXXXX|
|XXXXXXX00000000000000000XXXXXXXXXXXXXXXXXXX00XXXXXXXXXXXXX00000000000000XXXXX|
|XXXXXXXXXXXXX0000000XXXXXXXXXXXXXXXXXXXXXXX00XXXXXXXXXXXXX00000000000000XXXXX|
|XXXXXXXXXXXXX0000000XXXXXXXXXXXXXXXXXXXXXXX00XXXXXXXXXXXXX000XXXXXXX0000XXXXX|
|XXXXXXXXXXXXX00XX0000000XXXXXXXXXXXXXXXXXXX00XXXXXXXXXXXXX000XXXXXXX0000XXXXX|
|XXXXXXXXXXXXX00XXXX000000XXXXXXXXXXXXXXXXXX0000XXXXXXXXXXX0000XXXXXX0000XXXXX|
|XXXXXXXXXXXXX00XXXXXXXXXXXXXXXXXXXXXXXXXXXX0000XXXXXXXXXXX000000XXXXXXXXXXXXX|
|XXXXXXXXXXXXX0XXXXXXXXXXXXXXXXXXXXXXXXXXXXX0000XXXXXXXXXXXXX00000XXXXXXXXXXXX|
|XXXXXXXXXXXX00XXXXXXXXXXXX000000000000000000000XXXXXXXXXXXXXXX000000XXXXXXXXX|
|XXXXX00000000XXXXXXXXXXXXX0000XXXXXXXXXXXXX0000000000000XXXXXX00000000XXXXXXX|
|XXXXX0XXXXX00XXXXXXXXXXXXX0000XXXXXXXXXXXXX0000XXXXXX000XXXXXXX0000000XXXXXXX|
|XXXXX0XXXX000XXXXXXXXXXXXXX000000000XXXXXX0000XXXXXXX000000XXXXX000000XXXXXXX|
|XXXX00XX00000000000000000XXXXXX00000000XXX0000XXXXXXX000000XXXXXXXXX00000XXXX|
|XXX00XX0000000000000000000XXXXXXXXXXXXXXXX0000000000XXXXX00XXXXXXXXX00000XXXX|
|XX000X0000000000000000000000000000000000000000XXX000000XX00XXXXXXX0000XXXXXXX|
|XX00X0000000000000000000000000000000000000000XXXXXX00000X00XX000000000000XXXX|
|X00X0000000000000000000000000000000000000000XXXXXXX00000X00000XXXXXXX0000XXXX|
|XXX0000000000000000000XXXXXXXXXXXXXXXX0000XXXXXXXXXX0000XX0000XXXXXXXX000XXXX|
|X0XXXXXXXXXXXXXXXXXXXXXXXXXXXXXXXXXXXXXXXXXXXXXXXXXXX000XXXX00XXXXXXX0000XXXX|
|X0000000000000000XXXXXXXXXXXXXXXXXX0000XXXXXXXXXXX000000XXXXXXXXXXXXX000000XX|
|XXX000000000000XXXXXXXXXXXXXXXXXXX0000XXXX00000000000000000XXXXXXXXXXXXXX00XX|
|XXXXX0000000000000000000000000XXX0000XXXXXXX000000000000000XXXXXXXXXXXXXXXXXX|
|XXXXXXXXXXXXXXXXXXXXXXX000000000XXX00000000XXXXX000000000000000000000000000XX|
|X00000000000000000XXXXX00000000000000XX0000XXXXXXXXXXXXXXXXXX00000000000000XX|
|X0XXXXXXXX000XXX00XXXXX0XXXXXXXXX0000XX00000XXXXXXXXXXXXXXX0000XXXXXXXXXX00XX|
|X0XXXXXXXX000XXX00000000XXXXXXXXX0000XXX000000000XXXXXXXXXXXXXXXXXXXXXXXX00XX|
|X000X00000000XXXXXXXXXXXXXXXXXXXX0000XXXXXXX00000XX00000000000XXXXXXXXXXX00XX|
|X00XXXXXXXXXXXXXXXXXXXXXXXXXXXXXX00000XXXXXXXXXXXXXXXXXXXXXX000XXXXXXXXXXX0XX|
|X00XXXXXXXXXXXXXXXXXXXXXXXXXXXXXXXXXXXXXXXXXXXXXXXXXXXXXXXX0000XXXXXXXXXX00XX|
|X00XXXXXXXXXXXXXXXXXXXXX000000000000000000000000XXXXXXXXXXXX000XXXXXXXXXX00XX|
|X00XXXXXXXXXXXXXXXXXXXXX00000000000000000000000XXXXXXXXXXXX000XXXXXXXXXXX00XX|
|X00XXXXXXXXXXXXXXXXXXXXX00000000000000000000000XXXXXXXXXXXX000XXXXXXXXXXX00XX|
|X00XXXXXXXXXXXXXXXXXXXXX00000000000000000000000XXXXXXXXXXXX00XXXXXXXXXXXX00XX|
|X00X000000000000000000000000000000000000000000000000000000000000XXXXXXXXX00XX|
|X00X000000000000000000000000000000000000000000000000000000000000XXXXXXXXX00XX|
|X000000000000000000000000000000000000000000000000000000000000000XXX00000000XX|
|XXXX000000000000000000000000000000000000000000000000000000000000XXX0XXXXXXX0X|
|XXXX000000000000000000000000000000000000000000000000000000000000XXX0XXXXX000X|
|XXXX000000000000SS000000000000SSSS0000SSSS000000000SS00000000000XXX0XXX000XXX|
|XXXX00000000000SSSSSSSSSSSSSSSSSSS0000SSSSSSSSSSSSSSSS0000000000XXX0XXX000XXX|
|XXXX00000000000SSS000000000000SSSS0000SSSS000000000SSS0000000000XXX0XXXX00XXX|
|XXXX00000000000SS0000000000000000000000000000000000SS00000000000XXXXXXX000XXX|
|XXXX00000000000SS0S0SSS0000000000000000000000000000SS000000000000000XXXX00XXX|
|XXXX000000000000SS0SSS00000000000000000000000000000SS00000000000XXX0XXXX00XXX|
|XXXX000000000000SS0SSSS0000000000000000000000000000SS00000000000XXX00XXX00XXX|
|XXXX000000000000SS0SSSSSSSSSSSS000000000000S0S00000SS00000000000XXX00X0000XXX|
|XXXX000000000000SS0SSSSSSSSSSSS00000000000SSSSS0000SS00000000000XXX0000000XXX|
|XXXX000000000000SS0SSSSSSSSSSSS00000000000SSSSS0000SS00000000000XXXXXXXXXXXXX|
|XXXX000000000000SS0SSSSSSSSSSSS00000000000SSSSS0000SS00000000000XXXXXXXXXXXXX|
|XXXX000000000000SS0SSSSSSSSSSSS00000000000000000000SS00000000000XXXXXXXXXXXXX|
|XXXX00000000000SSSS00000000000000000000000000000000SSS0000000000XXXXXXXXXXXXX|
|XXXX00000000000SSSSSSSSSSSSSSSSSSSSSSSSSSSSSSSSSSSSSSS0000000000XXXXXXXXXXXXX|
|XXXX000000000000SS000000000000000000000000000000000SS00000000000XXXXXXXXXXXXX|
|XXXX000000000000000000000000000000000000000000000000000000000000XXXXXXXXXXXXX|
|XXXX000000000000000000000000000000000000000000000000000000000000XXXXXXXXXXXXX|
|XXXXXXXXXXXXXX00000000000000000000000000000000000000000000000000XXXXXXXXXXXXX|
|XXXXXXXXXXXXXXXXXXXXXXXXXXXXXXXXXXXXXXXXXXXXXXXXXXXXXXXXXXXXXXXXXXXXXXXXXXXXX|
|XXXXXXXXXXXXXXXXXXXXXXXXXXXXXXXXXXXXXXXXXXXXXXXXXXXXXXXXXXXXXXXXXXXXXXXXXXXXX|
|XXXXXXXXXXXXXXXXXXXXXXXXXXXXXXXXXXXXXXXXXXXXXXXXXXXXXXXXXXXXXXXXXXXXXXXXXXXXX|
|XXXXXXXXXXXXXXXXXXXXXXXXXXXXXXXXXXXXXXXXXXXXXXXXXXXXXXXXXXXXXXXXXXXXXXXXXXXXX|
|XXXXXXXXXXXXXXXXXXXXXXXXXXXXXXXXXXXXXXXXXXXXXXXXXXXXXXXXXXXXXXXXXXXXXXXXXXXXX|
|XXXXXXXXXXXXXXXXXXXXXXXXXXXXXXXXXXXXXXXXXXXXXXXXXXXXXXXXXXXXXXXXXXXXXXXXXXXXX|
|XXXXXXXXXXXXXXXXXXXXXXXXXXXXXXXXXXXXXXXXXXXXXXXXXXXXXXXXXXXXXXXXXXXXXXXXXXXXX|
|XXXXXXXXXXXXXXXXXXXXXXXXXXXXXXXXXXXXXXXXXXXXXXXXXXXXXXXXXXXXXXXXXXXXXXXXXXXXX|
|XXXXXXXXXXXXXXXXXXXXXXXXXXXXXXXXXXXXXXXXXXXXXXXXXXXXXXXXXXXXXXXXXXXXXXXXXXXXX|
|XXXXXXXXXXXXXXXXXXXXXXXXXXXXXXXXXXXXXXXXXXXXXXXXXXXXXXXXXXXXXXXXXXXXXXXXXXXXX|
0