20
79
2
2
HHHHHHHHHHHHHHHHHHHHHHHHHHHHHHHHHHHHHHHHHHHHHHHHHHHHHHHHHHHHHHHHHHHHHHHHHHHHHHHH
H000000000000000000000000000000000000000000000000000000000000000000000000000000H
H000000000000000000000000000000000000000000000000000000000000000000000000000000H
H0000000000000000000000000000000000000000PPP000PPP00000000000000000000000000000H
H000000000000000000000000000000000000000PPP0P0000000000000000000000000000000000H
H000000000000000000000000000000000000000000000000000000000000000000000000000000H
H000000000000000000000000000000000000000000000000000000000000000000000000000000H
H000000000000000000000000000000000000000000000000000000000000000000000000000000H
H000000000000000000000000000000000000000000000000000000000000000000000000000000H
H000000000000000000000000000000000000000000000000000000000000000000000000000000H
H0000000000000000000000000000000000000000000000000PPP00000000000000000000000000H
H000000000000000000YOU0000000000000000000000000000PPPPPP00000000000000000000000H
H0000000000000000000WILL0000000000000000000000000000000000000000000000000000000H
H0000000000000000000000000DIE0000000000000000PPP0000000000000000000000000000000H
H000000000000000000000000000000000000000000000000000000000000000000000000000000H
H0000000000000000000000000000=)000000000000000000000000000000000000000000000000H
H000000000000000000000000000000000000000000000000000000000000000000000000000000H
H000000000000000000000000000000000000000000000000000000000000000000000000000000H
H000000000000000000000000000000000000000000000000000000000000000000000000000000H
H000000000000000000000000000000000000000000000000000000000000000000000000000000H
HHHHHHHHHHHHHHHHHHHHHHHHHHHHHHHHHHHHHHHHHHHHHHHHHHHHHHHHHHHHHHHHHHHHHHHHHHHHHHHH
1
2 1 0 0 3 0 1 2 2 0 1 0 4 0 1 2 3 0 10 9


2 1 0 1 2 1 2 2 0 1 0 5 7
2 1 0 2 2 1 2 2 0 1 0 5 8
2 1 0 3 2 1 2 2 0 1 0 5 9
2 1 0 4 2 1 2 2 0 1 0 5 10
2 1 0 5 2 1 2 2 0 1 0 5 11