20
78
6
3
|XXXXXXXXXXXXXXXXXXXXXXXXXXXXXXXXXXXXXXXXXXXXXXXXXXXXXXXXXXXXXXXXXXXXXXXXXXXXX|
|XXXXXXXXXXXXXXXXXXXXXXXXXXXXXXXXXXXXXXXXXXXXXXXXXXXXXXXXXXXXXXXXXXXXXXXXXXXXX|
|XXX0000000000000000000000000000000000000000000000000000000000000000000000000B|
|XXX0000000000000000000000000000000000000000000000000000000000000000000000000B|
|XXX0000000000000000000000000000000000000000000000000000000000000000000000000B|
|XXXXXXXXXXXXXXXXXXXXXXXXXXXXXXXXXXXXXXXXXXXXXXXXXXXXXXXXXXXXX00000XXXXXXXXXXX|
|XXXXXXXXXXXXXXXXXXXXXXXXXXXXXXXXXXXXXXXXXXXXXXXXXXXXXXXXXXXXX00000XXXXXXXXXXX|
|XXXXXXTHEXXXXXXXXXXXXXXXXXXXXXXXXXXXXXXXXXXXXXXXXXXXXXXXXXXXX00000XXXXXXXXXXX|
|XXXXXXXXXXXAUTHORXXISXXSHARYAKINXXXXXXXXXXXXXXXXXXXXXXXXXXXXX00000XXXXXXXXXXX|
|XXXXXXXXXXXXXXXXXXXXXXXXXXXXXXXXXXXXXXXXXXXXXXXXXXXXXXXXXXXX00000XXXXXXXXXXXX|
|XXXXXXXXXXXXXXXXXXXXXXXXXXXXXXXXXXXXXXXXXXXXXXXXXXXXXXXXXXX00000XXXXXXXXXXXXX|
|XXXXXXXXXXXXXXXXXXXXXXXXXXXXXXXXXXXXXXXXXXXXXXXXXXXXXXXXXXX00000XXXXXXXXXXXXX|
|XXXXXXXXXXXXXXXXXXXXXXXX000000XXXXXXXXXXXXXXXXXXXXXXXXXXXX00000XXXXXXXXXXXXXX|
|XXXXXXXXXXXXXXXXXXXXXXX000000000000XXXXXXXXXXXXXXXXXXXXXXX00000XXXXXXXXXXXXXX|
|XXXXXXXXXXXXXXXXXXXXXX000GGGG0000000000XXXXXXXXXXXXXXXXXXX000000XXXXXXXXXXXXX|
|XXXXXXXXXXXXXXXXXXXXX000GGGGGG0000000000000000000000000000000000XXXXXXXXXXXXX|
|XXXXXXXXXXXXXXXXXXXXX0000GGGG000000XXXXXXXXXXXXXXXXXXXXXXXX000000XXXXXXXXXXXX|
|XXXXXXXXXXXXXXXXXXXXXXX000000000XXXXXXXXXXXXXXXXXXXXXXXXXXXXX00000XXXXXXXXXXX|
|XXXXXXXXXXXXXXXXXXXXXXXX00000XXXXXXXXXXXXXXXXXXXXXXXXXXXXXXXX00000XXXXXXXXXXX|
|XXXXXXXXXXXXXXXXXXXXXXXXXXXXXXXXXXXXXXXXXXXXXXXXXXXXXXXXXXXXXXXXXXXXXXXXXXXXX|
|XXXXXXXXXXXXXXXXXXXXXXXXXXXXXXXXXXXXXXXXXXXXXXXXXXXXXXXXXXXXXXXXXXXXXXXXXXXXX|

the author is sharyakin